"filename", "language", "C++", "Markdown", "comment", "blank", "total"
"e:\Users\Chris\Documents\code\Command\Main.cpp", "C++", 66, 0, 23, 18, 107
"e:\Users\Chris\Documents\code\Command\README.md", "Markdown", 0, 2, 0, 2, 4
"e:\Users\Chris\Documents\code\Command\include\Allied_Soldier.h", "C++", 32, 0, 0, 14, 46
"e:\Users\Chris\Documents\code\Command\include\Base_Soldier.h", "C++", 61, 0, 0, 22, 83
"e:\Users\Chris\Documents\code\Command\include\Button.h", "C++", 31, 0, 0, 9, 40
"e:\Users\Chris\Documents\code\Command\include\Classes.h", "C++", 19, 0, 0, 8, 27
"e:\Users\Chris\Documents\code\Command\include\Commander.h", "C++", 58, 0, 0, 15, 73
"e:\Users\Chris\Documents\code\Command\include\GUI.h", "C++", 20, 0, 0, 3, 23
"e:\Users\Chris\Documents\code\Command\include\MenuButtons.h", "C++", 34, 0, 0, 6, 40
"e:\Users\Chris\Documents\code\Command\include\State.h", "C++", 16, 0, 0, 4, 20
"e:\Users\Chris\Documents\code\Command\include\Target.h", "C++", 18, 0, 0, 6, 24
"e:\Users\Chris\Documents\code\Command\include\WaveController.h", "C++", 18, 0, 0, 4, 22
"e:\Users\Chris\Documents\code\Command\include\functions\geometry.h", "C++", 7, 0, 0, 4, 11
"e:\Users\Chris\Documents\code\Command\include\infocard.h", "C++", 17, 0, 0, 5, 22
"e:\Users\Chris\Documents\code\Command\include\particle.h", "C++", 15, 0, 0, 4, 19
"e:\Users\Chris\Documents\code\Command\include\particle_Bullet_Trail.h", "C++", 15, 0, 0, 3, 18
"e:\Users\Chris\Documents\code\Command\include\shotgun.h", "C++", 14, 0, 0, 6, 20
"e:\Users\Chris\Documents\code\Command\include\timer.h", "C++", 17, 0, 0, 4, 21
"e:\Users\Chris\Documents\code\Command\include\weapon.h", "C++", 19, 0, 0, 3, 22
"e:\Users\Chris\Documents\code\Command\include\window.h", "C++", 31, 0, 0, 5, 36
"e:\Users\Chris\Documents\code\Command\src\Allied_Soldier.cpp", "C++", 191, 0, 23, 55, 269
"e:\Users\Chris\Documents\code\Command\src\Base_Soldier.cpp", "C++", 68, 0, 5, 17, 90
"e:\Users\Chris\Documents\code\Command\src\Button.cpp", "C++", 59, 0, 4, 16, 79
"e:\Users\Chris\Documents\code\Command\src\Commander.cpp", "C++", 140, 0, 45, 31, 216
"e:\Users\Chris\Documents\code\Command\src\GUI.cpp", "C++", 137, 0, 18, 20, 175
"e:\Users\Chris\Documents\code\Command\src\MenuButtons.cpp", "C++", 82, 0, 4, 27, 113
"e:\Users\Chris\Documents\code\Command\src\State.cpp", "C++", 28, 0, 10, 7, 45
"e:\Users\Chris\Documents\code\Command\src\Target.cpp", "C++", 59, 0, 5, 18, 82
"e:\Users\Chris\Documents\code\Command\src\WaveController.cpp", "C++", 41, 0, 2, 11, 54
"e:\Users\Chris\Documents\code\Command\src\functions\Geometry.cpp", "C++", 40, 0, 9, 7, 56
"e:\Users\Chris\Documents\code\Command\src\infocard.cpp", "C++", 68, 0, 10, 16, 94
"e:\Users\Chris\Documents\code\Command\src\particle.cpp", "C++", 17, 0, 3, 4, 24
"e:\Users\Chris\Documents\code\Command\src\particle_Bullet_Trail.cpp", "C++", 24, 0, 2, 7, 33
"e:\Users\Chris\Documents\code\Command\src\shotgun.cpp", "C++", 66, 0, 3, 22, 91
"e:\Users\Chris\Documents\code\Command\src\timer.cpp", "C++", 21, 0, 1, 5, 27
"e:\Users\Chris\Documents\code\Command\src\weapon.cpp", "C++", 33, 0, 3, 11, 47
"e:\Users\Chris\Documents\code\Command\src\window.cpp", "C++", 23, 0, 0, 9, 32
"Total", "-", 1605, 2, 170, 428, 2205